Rows: 20
Columns: 25
0000001111110000000000000
0000000000010000000000000
0000000000010000000000000
0000000000010000000000000
0000000000011111111110000
0000000000010000000010000
0000000000000001111010000
0000000000000230001010000
0000000000000450001010000
0000000000023001111010000
0000000000045011000010000
0000000000010110000010000
0000000000110010111110000
0000000000010010100000000
0000000000010000100000000
0000000000010000100000000
0000000000010000000000000
0000000000010000000000000
0000000000110000000000000
0000000000010000000000000
